1010111010101010101010100001
1000000100000000000100001001
1010010000000000001000111011
1000000100000000000110000011
1001001000000001111001011111
1010100000000000000000000011
1000000100000000000000000001
0000000000000000000111100101
0000000000000000000001001011
0000000000000000000000000000